11111111111111111111
10076000000011100001
10611111111011101101
10011000000011101161
11000011111111101101
11011111116000001101
11011106010111111101
11011101010111110161
11000001000061100001
11111111110101100001
11100001110101111001
11100101110101110061
11110101118101100101
11110000011101000101
11111160000001111101
11011001611111111161
11010111011000111101
11101111010016000001
10100111000611111111
11111111111111111111
