11111111111111111111
11111111111111111111
11111111111111111111
11111111111111111111
11111111111111111111
11111111111111111111
11111111111111111111
11111100011111111111
11111101011111111111
11110001611111111111
11000111011111111111
11011111011111011111
11010000001160000011
11000000101101011011
10001010000000011011
10000000006000000011
11100000001000001111
11000100000000001111
11100000007001101111
11111111111111111111