11111111111111111111
11000000000000000011
11011111111111111011
11011111100000000011
11011116001111111111
11611100111600000011
11011101000011111011
11011100011116011011
11011111000000011011
11011060111101111011
11011010010110111011
11011010011100011011
11011010011111111011
11011000800600001011
11011710111111101011
11011110101110001011
11011110110110111011
11000006111600111011
11111111001100000011
11111111111111111111