11111111111111111111
11111111111111111111
11111111111111111111
11111111111111111111
11111111111111111111
11611111111111111111
11011111111111111111
11011111111111111111
11011111111111111111
11011060111111111111
11011010011111111111
11011010011111111111
11011010011111111111
11011000811111111111
11011710111111111111
11011110111111111111
11011110111111111111
11000006111111111111
11111111111111111111
11111111111111111111