11111111111111111111
11000001111100000011
11011100660001010111
11011010111111000001
11001111600000011101
11161101011111111161
11001111116000000101
11801100010111110001
11111101010111111111
11110001610111111111
11000111010111111111
11011111010111011111
11010000000160000011
11000000101101011011
11001010000000011011
10000000006000000011
11100000001000001111
11000100000000001111
11100000007001101111
11111111111111111111