11111111111111111111
11111110011160001111
10000110601100101111
16010111001110101111
11010111001100101111
11010000001101101111
11010110101101101111
11010100171101101111
11010101111101061111
11016001180101011111
11011111100061061111
11011111011111001111
11011060011011000011
11000001111011000011
11011101111000600111
11011101111101110111
11000001111101110111
10601111100001110111
11100000061100060111
11111111111111111111
