11111111111111111111
17666100001116666661
11106101111116100161
11116100000066110161
11666101101166610161
11611001111110610161
11611000011166610161
11611111111160110161
11611111111160110161
11611111110160116661
11610066666160116011
11610161016160116661
11666661006161111161
11111111006166610061
11110011016111611061
11100100006661600061
10011101011061600161
11011100011066611161
11000010111011111861
11111111111111111111
