11111111111111111111
17000100061110000001
11100101111110100101
11110100000000110101
11000101101100010101
11011601111110010101
11011000011100010101
11011111111100110101
11011111111100110101
11011111116100110001
11010000000100110011
11016101010100110001
11000001000101111101
11111111000100010001
11110011610111011001
11100100000001000001
16011101011001000101
11011100011000011101
11006000111611111801
11111111111111111111
